##..#..##.#..#...####..#.#..##.###.......###.###..#..######...#.#....#...##.###.......#.#..####.#..#......#.#...##.#..##.#.##.#..####.#..##.....#.....#....###.#.#....##..##.##.####.##.###..###..####..#.#.#####..#####.####..######.##....#..#.#...#..##..###....#...#####.#..###...##..#.######..#.##.#....######.....###..##..######.....#..##.##..#.###...####.#...#.##.#.#....####.##.###...####.#.#.#.###..##..##....#.#.#..###.##.###..##.#...##.#.#####.#..#...####..###.###...###.#..#..##.#...#....##.#....##...##.#.

#..##.#..#.##..#.#.##...##.####.....#..#.#######.#.####.##.#.#......#.#..####.#..#####.#...###..###.
.#...#...#..###.#..#.......########..###...###.#....######.#.#..##..#..###..####.#.#..#..#..#.#.#..#
#.##....#.###..#.#....###..#....##.##..#####.###.#.#.....#.###...#.#..#.###.##..##..#..#..#########.
.#######.##.#########.#..###...#..#.###...##..#.#########..#.##.#.##..###..##.#.###..##.#.###.#..#..
#......####.#.....###..#...####.####.###...#.##.##.##.....#.#..#....#..###.....##.#.#...###.##.##.##
...##.#####.#.#..##...##....#.#..#.#...###..#.#.#..#.#..##..#.##.#.##.####.#..#....##.##..##.##.###.
#.#...##..##..#...##..##.######.#..##..#.##.#########..##.#.#..#..#...#########..#.###..####..#...##
#####..####..###...##...#.##.##.#..#.#....#....#.#####....##..###.#####.##..#.##...###..##...#.#.###
.#.##.####.....#.#.##.####.##.####.######..##..#.#..###..#.##.#####.#.####.#.##.#.#......########.#.
..#......##...##...#..###....#....####..###.##..####...#.#..#.#...#...##.##.#...#.#........#........
.....#.#.#..#..#.####.#...####.#####.###.#.#.##.#.#.#.......#.#..##.#.###..##........###.....##..##.
##...#.###...####.#...##..##..##.#.###..##.##..##..###..###.#.##.#.##...#.#..###.##..#....###..#.##.
##.##....##..#.....###.#####.....##..##..###..###.#...##..#..#..###....#...#.##.###.##.##...#.....#.
###.######.#.#....#.#....##...####..#.##....#.##..##.#####.#.......#....#.#.#####.#..###...##.##...#
##.##.###.#..##.###....#.##..........##.##.#...#...#..###......#..#.###..##.#####.###..##.###.###.#.
..##.....#.####...##.....##.#..#....##...#.#...#..###..#..##.###.#...#..#.###.#.....#.#.###.##..#.##
#..#.######.#.#.####.#.#####..#..#..#.##..#..##.#...#.....##..#....#.#..#.##..###..#..##.#########..
..#.#.###.....##.#.##.#.##...###...#######.###.#...#..#.###.#.#..#....##..#.#..##....#.##.#.##....##
#.#.##.#.#.###..#.#..#.####..#....#...#..##..####....#.#...#.#...#.#.....#..###.##.#..#.##...#.#..#.
..###...#..###...##..##....#.....#.#.##.......##..#...##.##.##...####.#..#..##.....##..#..#..#.....#
..#.#....#..###..###..###.....##.#..##.##.###..#.##.#.#...##..#.......#.#....####...#.#####...#..##.
.#.######...#.....#....#.##.#.#.#####.##.#.#.#.#..###...#.#..#..##.###.##.....##.#..#.####.#.....#..
....#.#...##..#..##.###.#######..##...#..##..########..##....#........#..###.##.#.##.......##.#.####
##.#.##..#..#.....##...#.#...###.##.#..#..####....###..#..#....#..#..##....###..#..#..#..###...#....
##..##.#..#.##.#.#####..#.#.##.#.####..#.#.#.#.#..#.#....######.#..##.......###..#.###.#..##..#.##..
###...##.####.#.#..#####.....###.#.####...###.#.#.#....###.####.##.####..##..##..#.#.####...#..#.##.
..##..#..#.###.######..##..####.#......#.#.###.#.#...#....#.#....#.##.#####.....#.##.#.#.#.##.##..#.
#.#..#.#.#.###..##..#####..##....#.###..##.##..#.#..###.....##.#.#.#####........#####.#####.#.#..#.#
..#.##.....#..###...#.......#.#.##..#.#....#####.###.###.########.#.#.###..#..##...#..#..#........##
#..##.#..#....##.#....####.#..##..#......#....##.#...#..##.##.###...#.....##....#.####.#...#.###.##.
###.###.#..####.##..###..##..###..#..##.#.#.####...#..##..#..###.##.#..##..####.#.###..#...##.....#.
##..###...#...#.#.#.##.#####..#..####.#.#...#..#.#.#.#.#.##.####...########..#.###..##.#..#.#######.
######.##.#.#.#.#.######.##.####..####.#.#..#...###.....#.###..#.#.#.###.#......#..#..##..###.###...
#.##.##.###..###.#.#...#.#.#.#....#.#...#.###..####.#.##.....##.##..##....##..#.##...#.........#.###
.#..##....#.#..#.#..#....#.##.####.##.#.#...#.#.##.#..#..#.###..#..####..##......##.#.#....##..#...#
.#..#####...#.#..#.#....#.#.###########..##........##.###.##..#..##...###..##.#####..###.#.##...#...
###..##...#..##.###....#####...#.##...#..#.....#.##.#.####...##...######..#.#.##...########....#.#.#
##..####.##.#...#.#.###..###..#...##...#....##..#.....##.#.###....#..#...#.##...#.###.....###..###.#
#.###.#.##...##....####.#.#.###.#.#.#....#.##.........##..#.###..##..#...#.#.##....#..#.###.#..##...
#....#####..#.#.##..##...#...#.....#.#.#..##.#.##.#...##.###.###...#.###.#.##.####..#.....###..###..
#...#####.###.#....#..#..#..#.#.#..###....#.#.###.##.##.##..##..#..####.#...#.#.#.##....#....#.##.##
.##.....#.......#..##.##..#...##..#...#....#.#......##.#.####.#.#####.##...##.#.....#.#.###.#.####.#
#.###.#..#.###...#.........##..##..#.#.#.#..#.#..#..#.##..#.....##....##..##.#...##..###.#.#.#....#.
#####.####..###.##.###.###..#.##..######..###.##..#..##..#.##.#.#.###...#####.##.#..###.#.##.##.#...
.##.#...#.#.#....##.##...####.##..##.#.#.#.#..##.#.#.##.####....####.#.##..##...#......#.#####.##..#
.####......#.#.#...#.###.##..####.#.#..#.##.#.##...#..##.#.#..#....#.#.#..#..##..##.#...#.#.##.##.#.
.####..###.#.....#..#.##......####....#.#.#...##.#....##.#.#######...#..#..##....#...###..#.##.....#
###......##..####.#..#.#..###....#.##.#......#...#..##..#.#.#.##..##.##..#.#..#######..#..##.##.#...
#.#.#...##.#.#...#........##.#..#.#.#..#..##.#.......#..#.####..###.##..#.##.#....##.##..###..####.#
...####...##...#.##.#.##....#.###..##.###..##...#..#####...###.....###.##.###.##.#..#....#.##.#.#..#
.###.#..#..#...#..#.#.#.##.##..#.##.#.#...##..#......#...#..##.#.#.....#.#.....#.##....#..#....##...
.....#.##..#...###.#..#.....#####..#.....#.#.###.####....#.###.#.####.###.#.##.#.###.#.##.###..#....
.#.#..##....#...#..##.....##.#.#..#.#.#..#.......##.###.###.#.########.#.##.#.....#.###.#..#.###.###
####.#.#.#####.#.####.##.##.######.##..#...###......##...#######.#.##.####..#..##.####...##..##...##
###.#.....#.#####.#.#.########.##..#.#...#.######.###...##..#.#.#####..#.##.#.#.#..#..##..####.#....
###.#.#....#####.####.##.##..#..#.#.###...###.#...##...#.##...#.#.#.#.######..##....##.#.#...####..#
##..#.#.......###.##.#.##.##.###.#.........#.#.#......####.#.######.#####.#.#.##...##.#.#.#......#..
#..##.##.#.....#.#..###..##...#.####.#.####..#.#####.#.##...##...##.#####..#..##..###..#.#..#..###..
.#..#.###.....#.###.#..#...##.##.##..##.#.####..#..##....#....##.##...#.##.....###..#####....#....#.
###.##.#.##.##.##...#####..##......##....##.##.#....########....####..#..##.#.##...#.##..#.###...#..
.###....#.##.#...###...##.#.#.#.#....#...###..#..#.......#....##.....#.#..##.##.#####.##.##.#....#..
#...##.###...#.....#...#..####.#..#..##...###..##..##.....####.#######.#.#.#.##...#...###.##..##.#.#
###...##.###....#..#..###.#....#.#..##..#.#.##....####.###...#####...##...#...#..####.#......##...#.
###....##.#.###...#....###..#######.....##..##.#...####..###.##.#.####..#..##..####...####.#.#.#....
..##...###..##.##.#..###.##..####.#.##.........#####..####..##.##......#...##.#.##.#.#.#.#.#.#####.#
#.#.##.#.#####.##....#.....###....###.....#####.#.###..#.###.##.......#...####...##.#...##.#...##...
..####.###..###..#...###..#.#..##..##..##..##..##..####.########.#.####.....#...#.#.######...#...##.
#.####..#..##.##..#.#.##...#..###.#.....###....#..#.#.......#####.##...##...#...#.....##...##.....##
#.#....#.#####...###.####.#..####.#...##..##..###..##...#..#.#..#.####.#..##.##.#.##.#.#.#.#.####..#
#####.#.#.##.#...#.##.#...#####.#.....#..####...##.###........##....####...#..###..###......#.....##
..#..##..##..##....####.#.#.#...##.###.#...####..#....###.##.#..#.##...#..#.##..#.#.#...#..###....#.
#..#..####.######.##.#.###.#....#.#...##########..##.#....#...#.#.####..##.##..#..##.#...##..####.#.
##.####.####....###..#.###...#.####.#....##.##.#.#####.##.###..###...##.#...###..#.#..###.#.##..#...
#.#..#...##..######.#.####.#.###..##..#...#.#.####.#..##.##....#..###....#...###.#..##.#...#.#.#####
#...#..###...#....#..#.#..##.....#######.#...#...#...###.#.###......######..#.#.###..#.##..###.#....
..###.##..###.......#.##..#.##...##.#.###.##......##...##...##.#.#.##.....##..#.##..#..#..#.#...#..#
.###.####..##..#####..##.###.#...###.#.###.###....#########..#..#.####.##.##.#..##.##...##...#.#.#.#
##...#..#.#.####.#...##....#.####.#....#....###..##.####......###.####...###.###.##..###.#...#...##.
.########....#..##...#.##.#.###.#.#.#..##........#.###..#..####.#....#...####.###.###.####.###.##...
########...#...##.#.####.##..#.###..##..#####.###.###.####..##.##.#.#.#.####.####...##.######.###...
.##...#.##.##.###..####..#####..##.##.####...###..#.######.##.#.#....#.###...#......#.####.###.#..##
..###.#.####.#.#.......#...###.#.####...#..####..#.#######..#..###.#####.#...######.####..#...#..##.
#.#..###...#.#.##....##...#######...#.#..###.#.#...###......#.##.#.#####...##..##.#...###.....#.###.
#...##.#.######..##...##.#..##..#...#.##..#...###..#.##.#..#.....#....###.#...####..#.#...#.###.####
.##....###.#..###.#####.#..#....######.##..##..####..#####..#..###.##.##.#.#.#.###..#.....###...###.
.#.#.###.##.#..#.###.##.##.##..######..#..###...##.#....####.##...#.###.#.#.#.#######..#...#.##.....
.##.#..#####.#...#.#..#.#.#..#.#....#..####...##...###.#...##.#..##.#..##.#.#..#..####...#.####...##
........###...#.#.#.#..#..#.#..#...###..##.#.#..##.##.#..##...#.###.#...#.##..#.###..######..#.#####
.#.#...#.#.###.#..#####.##..#.#...#.#######.#.#.#.#..#.#.#.####.#.##..##.#..#..#..#..##.#####.#....#
#.#.####..####.##...##.####.##.##.#...##..#.#..##.....#####.....#.#...#..#.##..#.#...###...#..###...
.#.#.#..#....###.#.##.#####.###..##.#.##..##.#.####.#.#.#.#.#..##.#.#.#....########..#.###...#.#.#..
###..##....###.##.##...##.#.###.#.#.#.####...##.#.##.#..##..####..#...#.#...###..########.##.###...#
.##.....#......#...####.#....#.#.#.##.....#.#.#.#.##.#.....#.#.....#.###..###.#...##....#.##...#.###
#....##....#.###.###..##...##..#.###.#..#.####...###.#..##....#...#..##.##.##.##.###.#......###.#...
##...#...#.##.#.########.#..#####.###.#..##.#.###..#.###.#..#...#.#.#.#..#...###.#.#....#...####..#.
.###.##.#..#.###.#.#.....#.#......##...#####....#...####...#.###..#..##.#####..#...#..##..#.######..
..####....##.#...###.#....##....####..##.#.##...#...#.....#..####.####...#.#.#####........##.###.###
#..#.##.#..##..#..#....#.#.#.##.#...###...#.....##..###....#..#.#.##.#.#..#.##.#..#......#.........#
.#.......#.####.###...##.########...#..#......##.#..#####..#.##.#..#####.#########.#.##.#.#..#.....#
##.##.....###..#.####.##..#.#.#..#.##..#....#.#.###.###...#####....#.#.#####.##.#....#....#..##....#